"component","status code","not found","skipped","accepted","total","result","count"
"Total","5","481","14147","15682","30310","233","30310"
"address","200","0","55","97","152","TRUE","152"
"addtoany","200","1","7","37","45","TRUE","45"
"admin-toolbar","200","0","73","62","135","TRUE","135"
"better-exposed-filters","200","1","9","126","136","TRUE","136"
"block-field","200","0","13","25","38","TRUE","38"
"bootstrap","200","3","269","127","399","TRUE","399"
"captcha","200","1","20","227","248","TRUE","248"
"coder","200","3","12","41","56","TRUE","56"
"config-update","200","0","45","34","79","TRUE","79"
"consumers","200","0","10","30","40","TRUE","40"
"content-lock","200","1","113","1","115","TRUE","115"
"crop","200","1","97","18","116","TRUE","116"
"csv-serialization","200","1","1","2","4","TRUE","4"
"ctools","200","0","28","90","118","TRUE","118"
"data-policy","200","0","77","54","131","TRUE","131"
"dbee","200","0","2","42","44","TRUE","44"
"devel","200","11","72","296","379","TRUE","379"
"disable-user-1-edit","200","0","1","10","11","TRUE","11"
"dynamic-entity-reference","200","0","36","43","79","TRUE","79"
"editor-advanced-link","200","0","3","20","23","TRUE","23"
"embed","200","0","38","10","48","TRUE","48"
"entity","200","1","56","26","83","TRUE","83"
"entity-reference-revisions","200","0","56","26","82","TRUE","82"
"eu-cookie-compliance","200","0","81","208","289","TRUE","289"
"exif-orientation","200","0","1","2","3","TRUE","3"
"externalauth","200","0","3","12","15","TRUE","15"
"features","200","2","74","184","260","TRUE","260"
"field-group","200","0","78","75","153","TRUE","153"
"file-mdm","200","0","3","43","46","TRUE","46"
"flag","200","2","107","231","340","TRUE","340"
"gender","200","0","10","88","98","TRUE","98"
"geocoder","200","0","8","140","148","TRUE","148"
"google-analytics","200","0","28","168","196","TRUE","196"
"google-tag","200","0","14","93","107","TRUE","107"
"group","200","1","151","236","388","TRUE","388"
"image-effects","200","2","96","412","510","TRUE","510"
"image-widget-crop","200","1","69","54","124","TRUE","124"
"inline-entity-form","200","1","47","21","69","TRUE","69"
"jsonapi","200","0","4","20","24","TRUE","24"
"key","200","0","27","143","170","TRUE","170"
"kpi-analytics","200","0","6","18","24","TRUE","24"
"language-access","200","0","0","4","4","TRUE","4"
"layout-builder-restrictions","200","0","14","56","70","TRUE","70"
"lazy","200","0","5","120","125","TRUE","125"
"like-and-dislike","200","0","9","31","40","TRUE","40"
"link-css","200","0","1","10","11","TRUE","11"
"login-tracker","200","0","4","32","36","TRUE","36"
"mailsystem","200","0","32","14","46","TRUE","46"
"message","200","4","72","104","180","TRUE","180"
"metatag","200","0","60","930","990","TRUE","990"
"openapi","200","0","1","23","24","TRUE","24"
"openapi-ui","200","0","1","4","5","TRUE","5"
"openapi-ui-redoc","200","0","1","3","4","TRUE","4"
"override-node-options","200","0","10","13","23","TRUE","23"
"paragraphs","200","6","214","111","331","TRUE","331"
"pathauto","200","2","172","13","187","TRUE","187"
"poll","200","2","126","2","130","TRUE","130"
"private-message","200","1","62","182","245","TRUE","245"
"profile","200","1","49","63","113","TRUE","113"
"r4032login","200","0","13","47","60","TRUE","60"
"real-aes","200","0","2","7","9","TRUE","9"
"recaptcha","200","0","9","52","61","TRUE","61"
"redirect","200","4","38","159","201","TRUE","201"
"redis","200","1","2","28","31","TRUE","31"
"role-delegation","200","0","5","8","13","TRUE","13"
"schemata","200","0","2","11","13","TRUE","13"
"search-api","200","11","190","749","950","TRUE","950"
"search-api-exclude-entity","200","0","5","13","18","TRUE","18"
"search-api-location","200","2","7","67","76","TRUE","76"
"shariff","200","0","18","105","123","TRUE","123"
"simple-oauth","200","0","29","165","194","TRUE","194"
"simplesamlphp-auth","200","0","2","100","102","TRUE","102"
"social-api","200","0","6","12","18","TRUE","18"
"social-auth","200","1","14","62","77","TRUE","77"
"social-course","200","3","159","0","162","FALSE","162"
"social-geolocation","200","0","18","28","46","TRUE","46"
"social-json-api","200","0","2","14","16","TRUE","16"
"social-kpi-lite","200","0","8","8","16","TRUE","16"
"socialbase","200","5","155","29","189","TRUE","189"
"socialblue","200","6","107","29","142","TRUE","142"
"swiftmailer","200","1","31","79","111","TRUE","111"
"taxonomy-access-fix","200","0","3","2","5","TRUE","5"
"token","200","2","169","19","190","TRUE","190"
"update-helper","200","0","8","24","32","TRUE","32"
"url-embed","200","0","25","15","40","TRUE","40"
"views-bulk-operations","200","3","28","67","98","TRUE","98"
"views-infinite-scroll","200","1","3","17","21","TRUE","21"
"votingapi","200","3","63","107","173","TRUE","173"
"weight","200","0","3","14","17","TRUE","17"
"distribution","504","0","0","0","0","FALSE","0"
"drupal-core","200","68","1890","768","2726","TRUE","2726"
"drupal-core","200","12","1972","742","2726","TRUE","2726"
"drupal-core","200","29","2141","556","2726","TRUE","2726"
"drupal-core","200","36","2087","603","2726","TRUE","2726"
"social-badge","200","1","26","0","27","FALSE","27"
"social-birthday","200","1","24","16","41","TRUE","41"
"social-captcha","200","0","1","2","3","TRUE","3"
"comment-permission","200","0","3","2","5","TRUE","5"
"social-disabler","200","0","2","8","10","TRUE","10"
"social-elasticsearch","200","0","1","2","3","TRUE","3"
"hubspot-analytics","200","0","15","5","20","TRUE","20"
"social-poll","200","0","9","4","13","TRUE","13"
"sticky-comment","200","0","8","6","14","TRUE","14"
"social-translation-manager","200","0","2","20","22","TRUE","22"
"gpch-core","200","0","5","5","10","TRUE","10"
"gpi-migrate","200","0","15","80","95","TRUE","95"
"gpi-orchestrator","200","0","2","14","16","TRUE","16"
"gpi-validation","200","0","1","6","7","TRUE","7"
"oauth2-client","200","0","10","38","48","TRUE","48"
"acquia-connector","200","0","24","223","247","TRUE","247"
"advancedqueue","200","1","29","91","121","TRUE","121"
"ajax-comments","200","0","2","16","18","TRUE","18"
"contact-storage","200","3","37","81","121","TRUE","121"
"encrypt","200","0","14","66","80","TRUE","80"
"facets","200","18","75","361","454","TRUE","454"
"geolocation","504","0","0","0","0","FALSE","0"
"gin","200","0","30","72","102","TRUE","102"
"gin-toolbar","200","0","3","6","9","TRUE","9"
"graphql","200","0","47","267","314","TRUE","314"
"jquery-ui","200","0","1","5","6","TRUE","6"
"jquery-ui-accordion","200","0","1","2","3","TRUE","3"
"jquery-ui-datepicker","200","0","1","2","3","TRUE","3"
"jquery-ui-slider","200","0","2","1","3","TRUE","3"
"jquery-ui-touch-punch","200","0","3","4","7","TRUE","7"
"lightning-api","200","0","8","30","38","TRUE","38"
"lightning-core","200","1","30","40","71","TRUE","71"
"message-notify","200","0","3","6","9","TRUE","9"
"migrate-plus","200","0","32","134","166","TRUE","166"
"migrate-source-csv","200","0","1","15","16","TRUE","16"
"migrate-tools","200","0","29","91","120","TRUE","120"
"openapi-jsonapi","200","0","4","31","35","TRUE","35"
"openapi-rest","200","0","3","9","12","TRUE","12"
"openapi-ui-swagger","200","0","1","3","4","TRUE","4"
"scheduler","200","1","27","232","260","TRUE","260"
"select2","200","0","10","28","38","TRUE","38"
"social-tour","200","0","7","36","43","TRUE","43"
"typed-data","200","0","8","43","51","TRUE","51"
"ultimate-cron","200","1","27","242","270","TRUE","270"
"variationcache","200","0","0","2","2","TRUE","2"
"video-embed-field","200","0","16","63","79","TRUE","79"
"webform","504","0","0","0","0","FALSE","0"
"webform","504","0","0","0","0","FALSE","0"
"social-avatar","200","0","4","22","26","TRUE","26"
"social-certificate","504","0","0","0","0","FALSE","0"
"gpfr-core","200","0","0","3","3","TRUE","3"
"gpde-core","200","0","0","3","3","TRUE","3"
"gpde-helper","200","0","1","2","3","TRUE","3"
"gpde-orchestrator","200","0","14","2","16","TRUE","16"
"gpde-sso-shop","200","0","4","20","24","TRUE","24"
"gpnl-core","200","0","2","10","12","TRUE","12"
"gpru-core","200","0","0","3","3","TRUE","3"
"gpsp-core","200","0","4","17","21","TRUE","21"
"gpde-local-group","200","0","8","0","8","FALSE","8"
"gpde-volunteer","200","0","2","21","23","TRUE","23"
"regio-twente","200","1","79","76","156","TRUE","156"
"saas","200","0","107","68","175","TRUE","175"
"glossary","200","2","0","0","2","FALSE","2"
"antibot","200","0","5","21","26","TRUE","26"
"ginvite","200","9","36","52","97","TRUE","97"
"oauth2-server","200","0","41","122","163","TRUE","163"
"sendgrid-integration","200","0","8","77","85","TRUE","85"
"social-admin","200","0","15","15","30","TRUE","30"
"social-newsletter","200","0","4","6","10","TRUE","10"
"social-search-autocomplete","200","0","2","2","4","TRUE","4"
"social-eu-login","200","0","3","15","18","TRUE","18"
"social-dashboard","200","0","10","4","14","TRUE","14"
"social-automation","200","0","61","243","304","TRUE","304"
"social-spam-prevention","200","6","14","3","23","TRUE","23"
"social-webhooks","200","3","5","20","28","TRUE","28"
"social-gamification","200","89","54","105","248","TRUE","248"
"social-resource-library","200","0","69","22","91","TRUE","91"
"social-migrate","200","0","11","34","45","TRUE","45"
"social-scheduler","200","0","7","17","24","TRUE","24"
"social-saas-saml","200","1","23","103","127","TRUE","127"
"social-clone","200","0","4","14","18","TRUE","18"
"social-oauth","200","0","1","3","4","TRUE","4"
"social-mailchimp","200","0","6","36","42","TRUE","42"
"social-restrict-ip","200","0","2","11","13","TRUE","13"
"social-saas-language","200","0","2","0","2","FALSE","2"
"social-disability","200","0","4","3","7","TRUE","7"
"social-tfa","200","1","4","26","31","TRUE","31"
"social-node-statistics","200","0","10","18","28","TRUE","28"
"social-pendo","200","0","1","10","11","TRUE","11"
"social-realtime-collaboration","200","0","13","65","78","TRUE","78"
"social-calendar","200","0","13","14","27","TRUE","27"
"social-discussion","200","13","56","61","130","TRUE","130"
"social-webpurify","200","1","10","29","40","TRUE","40"
"social-task","200","18","6","25","49","TRUE","49"
"social-video","200","0","16","41","57","TRUE","57"
"social-gender","200","2","3","9","14","TRUE","14"
"social-paragraphs-user-roles","200","0","1","2","3","TRUE","3"
"social-thx","200","0","6","4","10","TRUE","10"
"social-saas-permissions","200","0","8","0","8","FALSE","8"
"social-collaboration","200","0","20","18","38","TRUE","38"
"social-signup-redirect","200","0","3","11","14","TRUE","14"
"social-antibot","200","0","1","2","3","TRUE","3"
"social-chat","200","0","26","192","218","TRUE","218"
"social-smart-notifications","200","0","1","4","5","TRUE","5"
"pdf-using-mpdf","200","0","12","94","106","TRUE","106"
"social-o365","200","0","9","56","65","TRUE","65"
"social-saas-dev-helper","200","0","6","1","7","TRUE","7"
"social-content-export","200","0","18","4","22","TRUE","22"
"social-clone-group","200","0","4","14","18","TRUE","18"
"social-organization","200","8","68","163","239","TRUE","239"
"social-seo","200","0","1","2","3","TRUE","3"
"social-layout-builder","200","0","11","9","20","TRUE","20"
"social-course-scorm","200","0","31","42","73","TRUE","73"
"social-advanced-image","200","0","25","11","36","TRUE","36"
"social-resource-suggest","200","0","17","33","50","TRUE","50"
"social-encrypt","200","0","1","2","3","TRUE","3"
"social-profile-extra","200","0","9","25","34","TRUE","34"
"social-real-time","200","0","1","18","19","TRUE","19"
"social-challenge","200","31","115","129","275","TRUE","275"
"social-saas-analytics","200","0","2","0","2","FALSE","2"
"social-wootric","200","0","1","8","9","TRUE","9"
"social-engagement","200","0","1","24","25","TRUE","25"
"social-saas-core","200","0","30","1","31","TRUE","31"
"social-app","200","0","18","20","38","TRUE","38"
"ve","200","3","48","237","288","TRUE","288"
"social-monetization","200","3","78","302","383","TRUE","383"
"social-course-quiz","200","2","162","0","164","FALSE","164"
"social-cookie","200","19","1","2","22","TRUE","22"
"social-webform","200","4","7","4","15","TRUE","15"
"social-ethnicity","200","0","2","3","5","TRUE","5"
"social-tag-moderation","200","0","2","11","13","TRUE","13"
"social-grouptab-management","200","0","7","3","10","TRUE","10"
"social-datalayer","200","0","5","20","25","TRUE","25"
"social-onboarding","200","1","16","10","27","TRUE","27"
"social-registration-fields","200","0","5","5","10","TRUE","10"
"social-swiftmail-sendgrid","200","0","6","8","14","TRUE","14"
"social-comment-export","200","0","13","3","16","TRUE","16"
"social-trending-tags","200","0","2","4","6","TRUE","6"
"social-search-solr","200","0","1","7","8","TRUE","8"
"social-related-content","200","0","2","15","17","TRUE","17"
"social-usercentrics","200","0","3","16","19","TRUE","19"
"social-role-visibility","200","0","3","20","23","TRUE","23"
"social-gtranslate","200","0","2","6","8","TRUE","8"
"social-role-delegation","200","0","2","18","20","TRUE","20"
"social-user-purge","200","0","1","9","10","TRUE","10"
"social-search-grid","200","0","13","62","75","TRUE","75"
"social-group-staging","200","0","6","9","15","TRUE","15"
"social-auth-extra","200","0","14","98","112","TRUE","112"
"social-oe-webtools","200","0","1","4","5","TRUE","5"
"social-comment-extra","200","0","4","8","12","TRUE","12"
"social-sitemap","200","0","1","2","3","TRUE","3"
"social-renamer","200","0","4","11","15","TRUE","15"
